ACHARD	Bastien		5
ALLOUCH	Imen		2
ALLEGRE	Matthieu		1
ANDRIAMAKAOLY	Jeremy		1
ARBISA	Maxime		1
ARONIO-DE-ROMBLAY	Axel		2
ASSARAF	Karene		3
AYADI	Wadie		3
AYMONOD	Maxime		5
BAKIR	Myriam		1
BELLAHSEN	Otmane		4
BEOGO	Wend-La-Sida		3
BERREBBI	Nathan		5
BERTHIER	Paul		1
BESBES	Ahmed		3
BLANCHET	Aymeric		2
BOISDUR	Lea		4
BONANNO	Stephane		3
BORNE-PONS	Hugo		2
BOST	Lisa		5
BOUDET	Matthieu		1
BOUTAUT	Pierre		2
BOUYOUX	Guillaume		2
BRETON	SEbastien		3
BRISTOL-COURGEON	NoEmie		2
BROOKS	Daniel		1
BUFFET	Matthieu		4
CAMARA	Issa		2
CHABOT	Vincent		4
CHEBAANE	Radhwane		1
CHENG	Yu-Ling		3
CHENNA	Sarah		4
CHEVALIER	Mathieu		3
CHOLLET	Paul		5
COHEN	StEphanie		5
CONGARD	ClEment		2
CROZE	Romain		5
DAUBRESSE	Nicolas		1
DE-SAINTE-AGATHE	Pierre		2
DEBERDT	Guillaume		4
DECOUZON	REmi		3
DIAZ	ThEophane		5
DUBOIS	Angelina		2
DUDRAGNE	Geoffrey		1
DUVAL	SEbastien		4
DUVERGIER	Simon		5
EHRENSTREM	Axel		1
FERRIE	Baptiste		1
FONTAINE	Charly		1
FOURATI	Sami		5
FOURNERET	Audrey		3
FRANCIS	Danny		4
GARREAU	Corentin		2
GERARD	Henri		5
GHARBI	Wiem		4
GIRAUD	Benedicte		2
GIVAJA	Gabriel		2
GODEL	Wenceslas		4
GOESTER	Nicolas		3
GOSSELIN	Alice		5
GOTCHAC	Nicolas		2
GROSCOT	Raphael		3
GUEDOU	Thibaut		4
GUILLET-GROBOILLOT	Adele		1
HADDAD	JErEmy		4
HAMAIDE	GrEgoire		4
HURABIELLE-CLAVERIE	Adele		2
HUSSON	Antoine		5
ISNARDY	Antoine		5
JARRY	Viktor		2
JIANG	Paul		1
JMAIEL	Wajih		2
JOUMAR	Soufiane		1
KAHN	Antoine		3
KANMOGNE-CHATCHUENG	Joffrey		1
KERIBIN	Muriel		3
LABIADH	Marouene		5
LACROIX	Corentin		2
LALAMI	Soufiane		3
LALLEMENT	GuEnolE		1
LE-GUEN	Yann		3
LE-QUESNE	TimothEe		4
LELONG	Agathe		4
LELOUP	LEonard		4
LEMAISTRE	Laetitia		5
LOLLO	Daniel		4
LORIEUL	Titouan		5
LOUDET	Julien		3
LOUIBA	Sofiane		5
LUTFALLA	Adrien		2
MACHRAA	Aimane		1
MAMI	Mohamed-Hassen		5
MARCELLIN	Jean-Baptiste		2
MARTIN	Simon		3
MATISSART	Adrien		4
MESSAGER	Antoine		3
MEYER	Arthur		5
MICHEL	Louise		2
MOUJAHID	Sara		3
MOURY	Charles		4
NANAKASSE	Fatoumata		3
NEJMI	Anas		2
ORMEZZANO	Thomas		4
OUAKI	Arthur		3
OULHAJ	Mohamed		4
PAILLOT	Guillaume		5
PENG	LEa		4
PETKANTCHIN	Ivaylo		5
PIATTE	Guillaume		2
POTIEZ--GALI	Hadrien		3
PRIEUR-DREVON	GaEtan		5
QUENEE	Emile		1
QUINTIN	Virgile		1
RAIMUNDO	FElix		1
RAINER	Gilles		3
RANAIVOSON	Cynthia		4
RANDRIANALIJAFY	Tahina		2
RHAZI-FILALI	Nora		5
RIBAULT	Alnour		3
RICHET	Gabriel		2
ROEDER	Damien		4
ROTELLA	Yann		4
ROUSSEAU	Thomas		5
ROZES	Emilie		2
SAYAG	JErEmy		1
SEIGNOL	Edouard		2
SIRBU	Maxime		1
SOULE	Guillaume		4
SUCHET	Guillaume		5
TANAKA	Alban		2
TANG	Mengmeng		5
TASSINARI	Olivier		5
TIMOFTI	Vincent		3
TORRENTS	Alexandrine		3
TOUSSA	Delali		1
TRINQUIER	Nicolas		3
VALIOLLAH-POUR-AMIRI	Valeh		1
VALLET	Hugo		2
WADIL	Hakim		4
WULFMAN	Pierre-Emmanuel		1
YANG	Dominique		3
YCART	Adrien		1
YEMBELE	Alexandra		5
ZARROUK	Skander		4
ZHANG	Xudong		4
